200
000000000054600080008704160007040630000296000061070200039501800070002350000000000
000000000060320400908041003700002300030804060005600007100460702004093050000000000
000000036531207090040890000000100000050309020000008000000082060010405278480000000
000000050000230008002768043000003009060129070200600000750316200100082000020000000
000000070708620300030940060000000790042000510057000000020053080004062901060000000
000001000026000045300540020000090367000136000863050000070085004980000670000600000
000002000000560000001809200702603940080010070019204308004706100000058000000300000
000002070000050094000104000503007281008020300274800906000905000620010000050200000
000002700870901002006738009002300000000000000000004600900473100100809073008200000
000003000008700000007098640709601030002080900010904207085170300000006100000800000
000003010200000600034801500103702900000090000005106802002607450009000006040300000
000004010810207040000690000280000570001000200046000039000056000060302058050800000
000006000100900003605034800300610400700020006002045008007460201200007005000200000
000007000009400100030902080308106470000070000057304601040601030006003900000200000
000007004850000601000000870304801500600000002002706108046000000708000056200600000
000008070900000000005000023019054207400601009206870140570000300000000006060400000
000020000008940000009600370000405260720000054084206000062004900000019700000060000
000020000023470080000091020002000050154000873030000200060740000080052710000010000
000035010206008400090000080930501000600090004000603071060000040003100208080370000
000040200090013070100000630500030040006209100010060002057000004080390020002080000
000042800000500000600103000501090370200805001096020508000208003000009000004710000
000047000020090400980050000603402059000000000840905102000010043005020010000630000
000054000060039010008100500950000600610090073007000095006003900030420080000970000
000057000095203000103000000000004872800906003537100000000000401000401760000720000
000060004000090005107820306902007000080000060000500809809014603600070000400050000
000061900000709000100058000387000040609070503020000798000380004000506000003120000
000070000070500080009801600006208150500010004081406700003105200010002090000030000
000070003035004018062000000020908007300040001500603080000000190610500840200060000
000070800400500300000604000038900254020000010516002930000206000009008003007030000
000071023005008600000000009903100060060907040080004302600000000008400200750820000
000076003000000070007054208001000052002705100650000700403120500090000000700560000
000087010170060020000400000500706800630050042002903005000004000060090034090230000
000090000000802400080147000045000930801000607062000840000473060003905000000010000
000090000005702006064500370080000200051020640003000010012009560300207900000060000
000200000000065400042390700080000609076080230903000070008053940004810000000006000
000207800005030060300041025086000009000000000500000310870310002050080100001502000
000230000800900200109675003000840000600000005000056000400369507003007009000081000
000230098000100700290040100730009080000080000080400017004070056007004000960025000
000251000000040000003708600508000701390010048104000903007103800000080000000475000
000260000900000400051048000000980504800405007305012000000820960007000003000093000
000304500700600820020005003068091000000000000000780190900200030042008001005107000
000320090003009500000000670402000710010574060037000908094000000006800400050046000
000350800000000000408720600000905302905080107803602000009037204000000000004061000
000398060600540003000000000510000207260000041904000058000000000800032009050769000
000400000008207000009003860087604052000000000540809730071900500000308400000001000
000480300000072500570000000090201005630000081100806070000000029004360000009028000
000500010000009802000000906109002078002807100470600209801000000706400000090005000
000507000020104860090003000953000012000050000210000675000300050041906020000705000
000520480005007026080060507310000000000000000000000098903050010140200900056094000
000700500203158000009000001000207004804000302100406000600000400000645809008003000
000793000005002000000084070853000004709000608600000937060420000000300200000658000
000843000000907100030002000712000058300000006860000497000200070008105000000436000
001000006004089030000065000108050400006802900003070608000690000030240800700000200
001000400000390000300460001000904570029000810017602000600035008000049000004000700
001000670360059080200070001020000000034060720000000060600080007070510096045000300
001007000054206070000009023437000010000000000010000364180900000070301940000800200
001007090780050060004000107300405000090010070000809004203000500040020083070500900
001008000000460000006100709600040150050306020084020006209003800000094000000200300
001703060805010030000000070502006000904000602000400305020000000090020703050801900
002000391600000000158030700000004800080673050007800000006040932000000007723000100
002050004000034700400002090090000600107906305006000010010300008008210000300090500
002809070307000100060030028100000007005000600600000004730080050001000809050201700
002830000060407000000509000710040086090000070840070012000702000000104090000058200
002893040807054000000006000700008001000902000400300005000400000000180904030629800
003000010980002360040500008010080400000491000009020050500003090097600043030000600
003200007200008093000005002100580000507000206000027004300800000890300005400002600
004000080030700000927008300009305600070000030001206900002800714000001050010000800
004002060500014000000070001230108000046000190000403087600020000000940002050300900
004006020302800000006020489200000030005000600010000008968010700000007905050900800
004008000075000410060140035500000700006020900009000003340092080057000290000600300
004300170500007000200050006050603009003000500800501030900030004000400007048005200
004800395000002000000509000500043702040070050708920004000706000000200000827004100
005040900000039000200600007040307100710060093008401050100006009000980000009010200
006050420780001060400090005040000000201000706000000050900060008020900013063080500
007001002030042010000050307000100903006000700308009000503010000080390040400200100
007005020500000490800940000308000000609803105000000806000012009063000007090300500
007100090900002000005007204051080002000201000800060410203700500000900001090004700
007805000000300000204600005000160057610000098790048000100006302000003000000401800
008040960300000000506039407007000000205000801000000600701860205000000006053090700
008064000000003400031090608390000000205070803000000064602080310003500000000310200
008103020504000100030005048803000004000000000900000207380700060007000805060801400
008340010100000400020007008004020001200401006700060800300900080009000004070014500
010000000046501008003900104900008042000090000170600003401007500800406370000000080
010067090000000480095800700006100000701000903000009200009005820078000000030780050
010083000030600085008700900800000360300000002075000001003002500920004030000310020
010094070400020506020500000200000300830010057009000001000008020602040005080270040
010700035670900140000006000090600000004397800000004070000800000056003029120009080
013079004007000053004000700005200006000135000200006500002000600670000800100620340
020346000000908706080000000150000068400000005890000043000000050305207000000615020
020703000000600001000240000950300780600978005071006039000032000500007000000804010
020907500000006004400500000530602407000050000102704053000003009200800000003209060
030000200090014063400007000067902000050000090000805610000400006240780050003000020
030500000008006002007830910070000306002000800803000040084067200700100600000009080
035000840200000690000000701000094208020000010806170000408000000069000003052000180
036910508902004070100000000004030006000000000500080900000000002040300107301076490
040050000000070008000263000003406100716000349002107600000645000800010000000020010
040308090500670004000000000600703059020000060380406001000000000100034006030102040
040600500009000403360002010004508001000000000500207600070900086408000100002001040
047001000005006180000730060000009030470060091010300000060058000024600300000200610
050004000000219007000030000540803010083070650070105039000090000400621000000300060
050100000003080004004002850008070009030896070700050200027300100300020600000007030
050400003060150000032070060006008000004702100000600800090060380000081020200007090
050690120300000070002004006000860000703040905000059000200400600070000004094016080
052000640700400001400083005001000050005090100070000900900370006500001009063000720
060000003000800200000730408000015007052607380700480000401079000003008000500000030
060080050150003964020005000094000000500000001000000820000500070745200013030070040
060108300000900006800070000200090083001506900970020004000050009500009000002407030
070001080500002009000609000435908100000040000008706534000203000600100007050800020
070020500002300406980000020000030010100842003020010000030000048608004900009080070
070050200849001000000080009000107600016040950003506000500060000000300426004070080
070204510504090008000300400005030000080000030000010900007006000800040703042703080
070300100010006095200005000097402001000050000100809340000500002960200080001007030
071000000032000069900300081008053100000000000004960200510009004780000930000000810
073001000009470000600000070500090108090608050408050006020000007000014800000700360
076900000005000304030008069003502006000090000500406100710600030302000600000001890
080000700072905041300000050010204080000000000090501070020000008430806190006000030
080007030050089006000100007000001705070826040103900000800003000500690070060500080
080007090500080000904530007809000050030000070020000908600074309000010004090600020
080009730003500009000000000096800375200000008458007210000000000900001600015400090
080032100000000002105007800509020000800409005000070309007200401300000000004150030
080453700067000509000000300000004680090080030016300000008000000209000150003592060
080500000050304061000106000094000657000000000573000920000603000210905070000002090
080500020060000510000300000043720901050000030209035640000001000071000090030004070
082930040590080016000000009000000005420000091100000000900000000250070083070063950
090002070200600901017000800300706080000000000060203004003000510705009008020500040
090070000003502004000360010050000740307000106014000020060037000700408600000090070
090240030100000507040170000000000401809000205401000000000069050907000008060037010
091300060200860001000000900630027500000030000002610083005000000400083005080004290
096005730003400850500030000100020000000304000000050003000080009017009300089500410
097008040000050700001000008008042005705080403400510800600000100002030000080400350
097104030280000069000000007800050004000607000500030001400000000720000046050209780
098000700006901008200060095020000080001000200050000070980030007300704500005000830
100000200005008000000502640060093070307080504080250060053109000000800700006000009
100400002000508000000370000040030867007861900698050010000087000000103000200005006
102000007000901600098004501036000090000000000010000470901800360004205000300000204
200003007000900040000008106680094050900080004020370089306700000050009000800100002
200050039507039100030000060070000000490070083000000090050000040002340605140020008
200600037607004000001000980010706008000080000400105070023000700000300509960007003
204000010060059000700100930500010470000000000019040008026005001000830090050000704
205003080900200500040000100050800603000396000609004020006000040004002008080400907
207083900000000005040002008001007060870000091060300400900100070700000000004790203
290010004000030208030006000007305000150000032000108900000600020704090000500070089
300000062900000070006900045090030706700020009601080030410005600080000007560000001
300007004042000730071000560900803000000000000000209001065000840034000190700100002
300008064460001980080000000540709000000060000000804093000000030054900018830200009
300070908000000000704093500005601000106040302000502100001320805000000000903060001
300800006000190000008030100000080097075901820680020000002010400000056000900008002
301500007050300008008700100000490000062000470000026000009008500100003090500004806
305200900000530800602048000000005002001000700500400000000790504004016000007004608
307090081180005030000000004020401000500020006000809010400000000050900063860030407
370008000000059100200173040000007000008904200000300000030592006005840000000700051
400002000007038005280010069002000000800601003000000600190040036700150900000200001
400006092500014000000750000840000900057000620002000035000081000000640009760300001
400020001003006400020043060071000000604010309000000140080270010007900800500080007
400100069103040200050020080000000006078000910300000000030070090006010502820005007
400900008079008010006004290045000001000000000100000670061800500050200380900005006
400910008000000900089704100008000205100000003307000800001305760004000000700061002
401006500008009004020000003050000008209405701800000050100000020300500800005700306
401200500008000000090100040004702005230090067900503200060005070000000300003007601
430600020001000009502090070090008040200000007050400030020070103300000200010003065
470069000006500000000080017082000001607010208300000790530090000000001400000250083
470900000000065379005008002000000050040602080010000000300200600269570000000006027
480000000010006000207489000005203000003901500000608200000394806000800010000000035
480307502000009008500000000960104005000000000300502047000000004600200000701906053
500006000160340009000050673000005000390000085000100000246080000800013062000600007
500340067300002000007000400050020009200108004800070020001000200000200006960035008
501007003040002080000008006732090000000204000000030257100400000070100040900700501
501080760060000105000000032007000028000467000690000400970000000203000040086030209
502080030006003050300070094200300000030000040000008001910040007020800500060090403
507000100008001000000206003000408697080000040394507000800704000000600900001000704
540000809007090001300005060002070000050802090000060200060100004200050900405000023
567800103000720000100000907000500800000974000006002000204000008000067000609008215
570090600016004000000200070700400090029010540050009003030002000000800310007050062
600010008080094570040000000030402000210000053000103060000000020027940080300070004
604000070050080400030207000040001009069000140500900060000502010003090050020000908
608210405000008000100700009080000906900060004304000070800005002000100000703092801
610040009000870001005090400000000010349000526080000000001060700500023000900010045
700089002000700000004050100500040010103506409090030006005020900000005000200890003
700100006013805020000002050052000048000080000860000570030900000080706910900008005
705630200000000000264008000002306009000507000500801600000400386000000000009063702
709000000080070000024600900500304700400105009002706001001007540000060070000000208
709600103000000400163000702000090008000705000300020000608000514004000000502004809
740902008000003001003080400150000003008000100400000062007090600900600000500304079
800000500000305078070000324029003000001070600000900240567000030980107000002000007
800031200200096000400008000093205000600000009000309160000900004000840006007610005
800270060060000103700100000425000008900000002600000957000004001304000080090035006
800400001091570002004000000007000250520060049069000700000000900900035620200009003
800406012500800600020007000901000034000000000450000706000600040005008007340902008
800750002000300050000214300509030600000000000004070509003461000020003000900027006
803009207006100000200007045601000090000090000090000704360900002000002900908300401
860200009000064002000890000030000501058000320201000090000017000500940000600003014
870003160020004003003600000000001700030965080008300000000009400400200050085400019
870043005000700603030000000600207090300000008040908001000000050902005000500870032
900067008000501000000048000293000010708000506010000389000780000000402000300690007
900600240000000107001703000508060010000138000010050309000809700805000000029006001
900780502005000000400605010009000605200000004806000200070903006000000700304057001
903054000070000040420003100204000800060040030008000604005900016040000070000460503
930400002061000048000500010000603704000000000403207000050004000610000480300002061
950008001000760020300010000000090080809102503040030000000050007020086000100900058
950700100010000050602000000070039016001000800460210030000000201020000040003001075
