200
000000000000320100096005700003401060070000090040502300001700230005018000000000000
000000000000796438000003209000000090007204600020000000605100000134958000000000000
000000000007205400040160070030000280004000700082000030090031060005607900000000000
000000000040672150070005000025000040060090010030000760000200070058734020000000000
000000000063000950080130020000602700005070600007304000050089030012000890000000000
000000000080710060009408200005000630070000010036000400008209500020086040000000000
000000008079000010200050030000630001310000082900071000040010003060000240500000000
000000010801000700050902030002703100000000000005609400090106070008000501040000000
000000020326000090009080650000102000007000100000705000098060300060000519050000000
000000030050140690690008000000000902030010050401000000000800079026075080040000000
000000040306000900089040630000106000005080700000507000038020460001000308070000000
000000060004079800900000501100300049000090000730008005801000007005620100020000000
000000060237000010000805070005060200000902000001050400040103000010000649080000000
000000070200006100010704000069407800000030000007902640000109050004500006090000000
000000090560042370040006000032000000070080050000000160000600080097830025050000000
000000100080400070302070500000050030003602400070080000006030902050006010001000000
000000347007100000050000108070060005000748000600020030501000020000006900298000000
000000500020073000700954600200005030000040000090100008001328004000490060004000000
000000802000704000000300070529000086007000300460000791080009000000207000104000000
000000900008500400320070050000804030005000200010206000060040075002009300001000000
000001000000520600003000087000803040005902100080407000970000500001094000000700000
000003007281000050070000000007006400106040208005900300000000080050000619700800000
000004900050710060300050000100000080028000410030000007000080003070029040004300000
000005700000430900860000000600802030040070090020304005000000019005019000001600000
000005800000600400380210000900000350008000200072000004000039065005001000003800000
000006007200500100000097002030000009008603500500000020300710000009008003800400000
000007000300100006000063920100000470080030010072000008064370000500008009000500000
000008092600100007000006000000010850860090023052060000000200000700003005280400000
000009003000410080300006200630000870000070000029000051003200006090035000400100000
000009170600040000700302000402000800030000050009000604000806002000050003085100000
000010000007500800010480090000000160209060708081000000090036040002005900000090000
000010029001584070700000000014000080000000000050000340000000007040368100160070000
000018009002004706040000010800200000006000900000005001050000070709500300400760000
000020390804005700950000080080000000100060007000000020040000059009600103061030000
000023090408000000000600030700040500800205004005080001020009000000000607010750000
000030800009102000500900020040000730300000009071000040030001006000209400008070000
000034000005000000907082000070000051201070304460000070000650407000000800000920000
000038500001059004050000000210000003060000020800000097000000030500460100003710000
000038950190040060700000000200000000370060024000000009000000007040020016027810000
000057600090000040300100000800070300700531008001020007000002005010000030002790000
000060000053007090004000570030709000800010002000802010067000100090400820000070000
000070100600000009040000085300610000500902007000085002160000030700000006008050000
000073000450000006000600091060000840000902000021000070370006000200000034000830000
000080037060715800000000020009000000030602090000000400020000000006893070180020000
000090000004700100060052040002000080905020607070000200040830090008001700000070000
000090400000200700742001300003000010800000006050000900004600529005008000006040000
000180006000003200003000048001002009000301000400800600750000400009500000200094000
000200000000980100042005300004000062090050010160000500001800470003074000000001000
000200380002000960000301500240000070000000000070000015007804000069000700083002000
000200600040000080103080400000020004004791300600030000007050903080000070001009000
000234000050000040000708000307000608900000003105000407000803000090000070000196000
000300200020000503004500107050013000000040000000780030405006800208000060007002000
000304080900207100020000000150000067000000000260000038000000050007803006030405000
000401720500600000900080000800000014005000600170000008000020009000007002012309000
000405000000008600032010500750000004001000300600000089006030850007200000000704000
000420080600801900070000000040000015900000002320000040000000060004107008080095000
000460000100050090900000500072000001060142070400000250007000008040030002000018000
000500098059600000000200300020900410000020000095001020006008000000002730540003000
000504836003000000000009000702800000500691007000003508000200000000000100675908000
000549000000003000002000800910060005400197008700030019001000200000300000000974000
000600000070000080001248600009000305004020800806000700002731900090000010000009000
000600280700000900460001000009020003000519000500080400000100092004000008075002000
000605700030020050600400000100000509090050080305000001000007005040010020008904000
000607050000000084300005007100000090007403200080000006700800001250000000060702000
000610800040000070300009000002705009600090008800104500000500004060000050005047000
000700090050090700000020104610000570000000000073000061902030000004050020060002000
000700580040205170030090000000000006009000700300000000000080020074501030052006000
000709400000006100230050000170000006009000200600000058000080029006100000004507000
000710000002500600060009040008000092400030008270000400090600010005004300000091000
000980306800100000007000802000610000090000040000038000102000400000001003708045000
001000900000053000700600005070508200050000090008104070800006002000710000004000700
001007000000020300080530004200000800035040910004000006600091030008060000000400600
001400000000010000008079603007000008063000120200000700604280300000050000000003900
001560000000002300060030004020000008307010409400000030800050070002100000000079500
002000080000080209800023010004000005008030400600000700060940003209060000010000900
002001000073009020000000046780010000000823000000050084360000000040600850000100700
002400057006000800000035000030062000700000006000850090000510000003000700510009400
002900650000004000000100420005000107030070060801000900047008000000500000086003200
003000500020000840860005009004308000000000000000209100900500017076000080001000300
003020700002800000500000041000010090800504002060030000610000003000003500005070400
004000000000190700050024008009000040045080630070000800600350010001062000000000900
004000000000365800060000002030209070080000060020106030100000020003657000000000400
004000005007000090039600000600901030700000002040705008000008540070000300800000100
004002070007000903000000065108300500000010000005004801890000000501000200030900600
004002610000491000000000003600300900010060080002004001500000000000128000091600700
004002730000300004000000060290001080300020005080400097050000000900008000013500900
004008000000450700080009006608000030090020050020000408700100020005043000000900100
005000006000000070940038000020050008010402030300010090000560019050000000100000400
005000010000030007010700980608400000001090500000003702084006070100040000090000400
006000050749001020000000089080090000000507000000010090920000000010400976060000400
006008040250060190080000005300000000060050030000000002800000050091030084040700600
006030700000009200810000004040805000700020001000904080200000073001200000003090600
007000000004093000000800076040080600020675080005030020910008000000120900000000300
007008690400000700590000001600020000000587000000030002700000056003000008016900400
007052000090000020000096007509000000304080106000000509900860000030000090000510600
008400000040000000307509010000300500560000071002001000030904605000000080000003100
009030070000000004000926000000002047020603080370100000000758000900000000060040200
009070000000308400060004003073000090500090008090000130700800040001405000000020500
009200600070010050000000010000901870800000002014608000050000000040050080003002700
009470000000000000008690103000000604501000302602000000306051700000000000000063200
010000000005000708037020590000503000008040600000106000023070940609000300000000050
010006000000023590700050000480001000090080040000400038000090004069530000000600020
010007050500000201080020000700080000004275800000060002000090020402000006050600080
010700060620004039000020000050000002009030700800000040000050000540600093030008050
020000008306200000000705900095000007080000030700000590001408000000001605600000080
020006030870003061000800000410000900000000000009000017000002000750400026080700050
020060080500008003000400000090030100600801004003070060000007000800200007060090050
020304000000070108090100000300000907040030050801000003000005070706090000000703020
020604007600000004003910000009008700000090000005200800000081900300000006500402070
020800010310000095000070000000107004004000700900603000000010000750000061030009070
027030050600000009000700006000040200400906008005010000800001000700000005010060890
030000000000908005004073900061000030007080200090000860003890700100702000000000010
030000960100006003400100000010030700000504000008070020000002006900800002082000050
030075000000090007000801000206000700980000035004000602000108000600020000000360050
032078000800905001006003000980000000000000000000000074000200300300804006000310820
040000000009000807050301020002070400000503000006010900090704060805000300000000050
040015000000007008008030400580000000103090807000000091004080100900300000000250030
040085000000000609060003000803501000200000007000708903000100070408000000000840090
040170000090000745020003000006000008100000006900000400000500080879000050000039010
050000030602000004009003150005070000000291000000040900023100800400000501080000020
050000400002800007906000820000105060000000000070406000085000204200004600009000030
050001403000900060800000000070000810120080095068000070000000001010006000607200030
057109000000700009000060003100000086008040900290000005300050000400008000000403890
060000000000000507052710300000901200004080100009603000003068750201000000000000090
060008100030900458000000090070003000800000009000700020090000000186005030004200010
070000250504000009300200070000906700000000000006105000030004006600000405042000010
070040020120000036004000900000203000300010008000608000006000800790000045040080070
072006000004807002000000013520000080000000000080000035490000000600502900000400850
080000090410030028000409000004000500090070030007000100000703000970010062040000010
080304200006009004500000010270000008000000000100000069020000005800400100005703080
081000300000000068000004000000080019340106052510040000000500000670000000003000170
090002080400308002000006000812000040000000000070000198000900000600203004050700030
090005016000000000002068300100004000048000290000700003006140900000000000850200030
090400000000806100007000002500048600000603000001790008200000300006201000000005060
090500000800000000005720804502080900000000000004030206103092400000000008000004060
090620300304000090000000002000760208000000000607085000400000000030000509008039010
096000000002010506030000042000805000020000090000604000370000060809050400000000370
097008000060000013000420007600000100004030900003000005900074000750000040000800720
097800040800000003000600001000407106000000000704301000200004000900000007010005430
100000042360200080007000100000070090000802000080030000006000300030005067290000001
100000053008000000500004701000036000002408600000210000305100006000000400260000009
100009002000300600062001400904000020000050000080000704008500230005002000400100008
100009004000040900060071000207000000083000450000000709000210080002060000700500002
100065000605280070400000030000009000070020040000600000060000007050072409000140002
100200037700090800040000000000080003060301070500040000000000090002050006810003004
100700004005900000004003250007000062000000000380000100028300600000005300500001007
102049600370060000000000070009100004000000000800006100060000000000010085001580307
130600029500200408090000000000000014000080000280000000000000040906001003320005061
150060002000800004004500100000000780500070003092000000007006400300009000800050031
190600002000003800302500000003700000040010060000002100000001609001800000700005014
200010047100003900040000000010060000800427006000090050000000080002600005460080002
200050004008000100090003060001070000700204009000090700020300080003000200500060003
200060005060000270040950000000000300309010408002000000000049080018000060400080001
200090080000020070000704623000000100000845000009000000645201000030080000080030007
200600003008005700030000020060090001000803000800070050040000090006500300900001002
200708001000600000000030000900103078008000500140207009000040000000009000700802003
200904000304000000100503060070001800000040000008600090040106008000000507000402001
200910407000000000801050300000000006503000102100000000004020805000000000906035001
204000006080004050000360002030000700009000100007000080900085000020600010100000605
207800004000004000000702006064000105000000000901000820600307000000200000500006308
231860090000000080000300000100000230007050100094000008000006000050000000040082517
250674008040100000000000010000300100600000004009008000020000000000003060400962075
290000003084000065000700040000070100000908000009050000020003000950000310300000057
300000061900506000005800700080000270000000000046000030009001300000208007750000006
300000500000730200100000080600023070000407000030860001040000005007084000006000009
300000607007800100460000050000020060000301000020070000010000042008004300209000005
300008000520010000010900064000000007100743008200000000640001050000050036000800001
400000302000000000208106900003020600000705000009080500002603705000000000107000004
400000500005013020100087000000000960900070002038000000000190008020650300004000005
400000907100008000000560000604000301900030002801000709000012000000900005206000004
400008607020070040500200000700000900050030060001000005000007006060040070305900002
400090500080000000920007000009531800000000000005264700000900053000000020003010004
400670009000032000005000800080000006190000043500000090002000100000290000700013002
400910706000000090001000080010309000030050020000608070060000200070000000908061005
405300002000600900080050006000000067001000300670000000700010030009008000100005704
420009005008036000600000020004000090000384000030000700090000002000120400200700086
500000008008001206002400900000030060009020800070050000001008500705200600300000001
500902603000030000800001000301000007090000040200000901000200006000050000704603009
509048007000059000000000008260000000930000084000000065700000000000730000800620403
540000000087060020310400000000500008700000006400001000000009012020070350000000084
600000307000010000709650200000000400083090560002000000006024108000060000104000002
600001700900020004000004500302000009000853000700000403006900000800030007001400006
600085000450107000000300000090001600070060050005700020000003000000408072000970005
603010009002008100090000053020000000800040001000000070570000090006700500900060407
603800000080009030100703000005300000000958000000004700000407009030100060000002107
617800009000300008000040006000000065005010800840000000700020000900005000200009671
670450009040700035000000000000000083300070002780000000000000000510002090200069041
690100002004300001000000070000507084000000000170602000010000000400005800300001047
700040003003000000008005910004901000900050007000408100059800600000000400200090005
700058064300400000000001000905000020200000009030000105000300000000009008580210007
700100003002000000005003690006709008000080000900305100031200400000000300200008005
800002169030000000100000805000910000008000500000036000205000001000000070389100004
800609054500710000000000000700000096040000030260000008000000000000085001620407009
810000692300000004400002000002010000000374000000080500000400001900000003563000078
860320004000004009000007000036000002200040007700000930000400000500800000900012083
900000003000605000005090400070030080008946700020080040007050300000207000100000007
902000000060700190500030002070200004000090000800005020400080006059003070000000409
906040002000000700080060003000406000708010306000305000600020090001000000200050804
907002006000000900080400003200106800000070000008209005600001030002000000300600401
930250008000000006000034000002000001408000602700000800000590000300000000800017025
