199
000000000042760301000001472700093010300605007010280005458100000107024850000000000
000000008031009000892005010650940001100803007300071045060100539000500860900000000
000000610710406390390081000045000060002000900030000540000140073021603059073000000
000000900090230460160807000007020380080643010043070500000902053051064020009000000
000001070501700040600400100962070804000618000108020653006007005080002309040800000
000003000021706850050008030947205010000000000030609245070300020085902170000500000
000003000035790010002080750500060020048507390010030007056070200020045930000100000
000003906000406001094100003200804037800000004430207008900008160500601000701500000
000004320700380000403020800500060090072809530010070002008030205000098003047100000
000004390300000000701395600907801500002000700003702409006418902000000003019500000
000007000103600205809001340060302090007060400090708060038200104605004708000800000
000008204000001380084703609479010000000000000000080597802507130031800000507100000
000009100090001840100030600053070416060050080784020930009010008027500090005300000
000009500034002090608007410463020000000104000000060724047200608050900240001400000
000009620000571400850060017003050006002000100500080900790020031004318000018700000
000027560300005840506030209000000625000000000127000000201070906064500001039680000
000034000006009000009620830290050100508701203003040058031062500000900600000510000
000040000950007040004125930000004081010836020680700000037591800060400017000070000
000040790004273080300000020001008206900104005706500400060000007030625900049080000
000080650790600280460032000002000030604000801050000700000210065026009017019070000
000120000001060000004793560006000703389000412402000900063257800000030100000081000
000130070607080400905040300080000520020403010061000040002090708006020109090075000
000190000010405760020700000090050871300207009487010050000002090036901020000063000
000200500050867020709100400010000247070000090384000050007002604090486030008003000
000207000200408090791630004300920010000000000050076009600041583080302001000509000
000283500003000000500910070400806107609000802801709003080037005000000700005492000
000300060475000930060015080007506003001090600900801700020750010019000856050009000
000300400980000102050018607000407016040090070890105000608530040504000098009004000
000300700001400900592007380004103072000080000120709800069800235003006100005002000
000318760430000080700006000803050007600709005100030608000500003060000041078143000
000450007372168000004003000040001028060080040280600070000500300000729564400036000
000700080102065000000210040060020301074103960309070050090047000000690403020001000
000702503000090102570060000004000231005401900138000400000050029209010000307908000
000703020573002060000060030420108007001070200900406015050010000060200174040607000
000806910913400070600090050800000025005000700720000009060040003070009541049502000
000900004003874560702030008000007040008506100070100000800060407097481200300009000
000960000689304000374000096006009004008000700100400800420000583000103627000082000
001086395607523000080000000802000000016000540000000802000000030000231907723960100
001600090240390750079000403000000084010000020930000000407000860063072041080004500
002030040630870590095000703000000060320050089060000000209000630013086052080040900
004000002080700000905040016008073005049102870200480100410030507000004030300000400
004036070236000050005008613607000000400000009000000307362100500050000426040620700
004600000030452960062000307010000072020000030390000050209000780071238090000005100
005900000000851200078060305030000026056000430810000050209070810001493000000008500
006000080007048200290015007000503004020109060700406000400760019005390400010000600
006000100008420900120005048003050080050738060040090700680200097002076800005000600
006042000039008020002000159150406000400070001000205083964000800070800340000620900
006302000085060020002050186100000009043000850200000003591040700030090610000108900
006358400050000080300001009809030005600287003200040608400800002060000030001573800
006900000000103200090860001030040126004601700961070080300015040005406000000008300
007006000020080170090302004905604300030010040006803907700509060069030050000200700
007009250000700003050200780900100460704060108068002005042006070600001000091500300
007050010810002040000601009043807100700010008008203490300905000070100025020040300
007356000061900400095000006910800003008090100600001087400000610003009820000485700
008000010000102006200704500060300821002406900157008040003809007600507000090000400
008040070004007000070500481800104030703090204090205007981003020000600300030020100
008047000005180600046000281100000040920060015080000006432000150009051800000320400
008530000030060790050900002000806503360000019705309000500002030091050040000094100
008730060600089000001006804073000001510060043400000280109400700000670008080093500
009307000407091000030026910300204000900000002000709005096170080000950301000602500
010007400005001006900208050541030800000594000003080542020805001300400600009600080
010040300003605001500020080030102070108030902020408010070050009300204800001070020
010408092000519800079600010000060009000824000600090000050007380004351000120906040
013089062000006300070003040700004680001000700035800009060900050004100000920360170
014090306600047100000601085470000000500020009000000014340906000005370008209050630
020000610406952007700000040040090060060804070080010090030000006900637408074000030
020007500000056009603028100186000000072000960000000832005270408800610000001800050
020084931906010000000700000100002048004306100650100009000007000000060704487530010
020304010400006308060180000230000704004030600107000053000041030803600005040703060
024000000030007461010804009072306500000000000009108720500703040286500030000000890
027000006001003040640000052039540020002000500060039180570000031010800400800000270
030090501010620007002003040023000050080245010040000260050900100700054030208030070
030159000064000000001200075080500043103040608740006050470001800000000230000678010
030600089009004200004005006152800060000506000060003571300400600001700300290008040
031040000900008540400070006703000450190050087025000901600090004049700008000060190
034005000008007060600840193300070000750000046000090002462019008090200400000400620
034080650800000912000605000170200030009010200050004091000801000623000005081050720
036017000008000906072000831700206000600000004000401002847000310201000600000180420
040000050590047068002053400067000000034070820000000930006980300280430095050000080
040000800156030700000910300400600070075103480090007006009046000001070245004000090
040001520800920014000400000200190073030000040170032009000008000450063002016200080
040007100010006723760301000129000800000000000004000217000902078871400090003800040
040080050000900680706450001260004000410000079000200068600028107031009000020010040
046000070708000500000800096200087935900010007387920001850006000002000304030000680
048009650725060000001008002053000700400000006009000520900700200000030471037600890
049080305620000001800040070080500704070010050405007030030020009200000087908070210
050000000042090038009108260008904300060080040004306500017409800290030710000000050
050003400060410028304008100701000040040000080080000901009600807270041090006900010
050109060201000070030000108009053406000706000506480900602000040080000701040308090
060000803800016000000283100920700540000865000075009018007192000000350007403000050
060005270375006019208000350140000000000090000000000023083000104420800537091700060
060708020057000964002000803305000000081020340000000605708000100216000480090801030
062391007030002050000000120125060008000020000600010372046000000010500030200138760
062800090904302007000070052040000079006080200520000080490020000600708104010005930
064000000003600105080701093002070950000496000097020800530907080409003500000000360
067000300010070645845006209009000000020010080000000500604500821591040030003000950
070063000003400006000502040604705230900000007025906104040301000500004600000650010
071800000040000513063020804000060008002104300400090000106050730734000080000009640
072900000004000708050870024000050406006308200408010000210097040903000100000001950
076002000001000300890004060040089203910050086708260050020900037009000100000300940
078500020900004501050970006060000302002010400507000010700029060809700004020008790
080000000010905000045806000201600093308109402490008601000401380000302010000000040
080300900079000586560009030005060004000274000200090100020600018618000450007001060
084503000070000068002600403900070304000938000205060009503001900810000040000806130
089006000046000075007001869703040000000239000000060504672500100490000650000600980
090000100020006473743800500030020800000143000007050010002009657576200040004000030
090002010082005700013068400600000300130000029004000005005390180009600230070800050
090004100003720009100098020601000040047000310080000907050130004800056700006800090
090100030100000800630847100016090070008000600070060290002985041001000007080004060
090500040320006598010002000059804006000000000700605910000300050182400067040007080
093000500008042001106003829084000000060070030000000670839200706600830400002000180
100000057395087060000406090083000900060000010001000270010209000020510789730000001
100002306003100200750008040205030080000546000090020503020700035001004900907200001
100002500000904000020006148004060980850000024079050600681700050000801000002600003
100006940806300005024001000410600009700080002200007058000700320500008607037200001
100070603090200050500906000002050470600107005051040900000501006010003040805090002
100300750807194300006805010080000000700010005000000060030407200008239501094001003
100903754900010600740800000300000105070090040402000006000002067007060009684709001
107002000020000700003609020510700092706000504340008017060207900004000070000800406
160209040800007052007015060006003000010080020000500800090450200650300001020106035
168000925400080003500060004000305000056000730000706000200010009600030007391000846
170005638400017009600090000350000000061000940000000013000070004500930007732400095
200008403000075600639000500560010000090563080000020065006000759005980000903700004
204508090700040530061000840070000901000000000306000050018000270053090008020104305
210000500904006000053020100395000800060895030007000965008050340000400602009000018
245000107000300608368000402000060070000435000090020000406000925501006000709000316
260000004000300000801952700004008307070135020509400100002816903000003000300000085
260300089950001047000009000095203001000000000400906350000100000510800093640002018
275630080604500000800207000060009000540000072000100040000903001000002804010064325
300009002070061000000402710654000021000105000920000537065204000000980050200700008
300009004020004030001350900130506800005000300008201056003045600090600040500700003
300200001082073090000800070040607809020030010703104060010002000060740350400008007
300208000000079081790010000024060139000000000157020460000040056570130000000805002
301800004002405000007000918020070081000982000870060050738000100000103800400008603
315008904002009703970000015460000000000020000000000098690000071103800600704600589
320085009009061004000400080930000500170050043008000092040007000200540600600310027
340080025509010004000405090008000100950000072006000900090308000100020608830070049
360001208001000607748200930400000100000070000007000006015003769806000400904600013
400000008009008000807610005503007641090000080168300907900024106000500200200000004
400000073507381000000007080058010020020859040040030150060900000000576802270000005
400000201039270050800060040000040010014503820050020000070050004040038970508000002
400003501020700340315200700600000430000000000089000005003005264061009070207800009
400006509000170800760590000800000740094000230037000006000017092002059000903200001
400007015695002030200040000076008004000394000900700180000020006060400521540600008
400008001857094000000560000004019060230000017070380900000043000000620395900800006
400031020000060053500874006080300009900000001100009060700683005340020000010490002
406002003000800500050903006501608730000070000072405109600107090003009000700300205
406005002000082400010070008140307000032000570000906041500040080001530000800700903
407000208050403090200180005040000850006000900079000040900075004030204080704000506
410300806593000027600700030000007004006000500300900000040009003860000915109005048
421000706000406005600200009030040610000809000068020090800004007300701000507000841
450761000000093000093400000005106300206000907001908200000009120000830000000617039
500000000709000805002090170061759000208000706000268530043020900805000402000000007
500000094928003750063007120036000000000000000000000980097400510012500469650000003
500003009082004310040801060254000800000060000006000942020709050017500690900100008
500870490008001000600040010081009300209000801005300970070080005000900600053067009
504010607071000030600402019003000700700050003002000800410908002090000450307040901
507083009000400205406050803000000051000597000760000000609070108802001000300840906
509000401070001590481500702050000200000000000003000010905006874027400030306000109
520071086000040000700000309000080251300705008852090000601000005000060000470210093
540010008000007009006809400092401600400000007001708590005604800100300000300090056
540900072902030008000020050000090001027803540300070000010060000200040105760008024
600003045704900200050008060509304010000090000040601907010800020006007804480200006
600080007000700560457003000900500803041000970803009004000300648014006000200050001
600107089700000000005083600206010008008906500900070203003690700000000001520801006
600400002005030400010580070000608109086050320509304000030095040008040700900007001
600705019500060800020003000103080004060204050200050703000600040006010008910308006
607000009023070160090040075000504000035080410000103000810060050079030640300000208
608000050300048170500300000019000020257000468060000790000005007025130009080000605
619500003000000401082310506000000604007000100108000000201057340804000000300002719
700006003005009000006070490457018030800000004010740825023050700000900300900300002
700049100634102700002060008100504000000020000000807009800070900007408561009250003
700081006080700010000009070670100403508000109401006027090300000050007080100890005
700350008000629500090004000028000049670000052950000830000200080009548000400096005
708904002060000970010058004903000007005040200800000503100320040097000020300407806
709205036102030070008047000200000005000328000400000002000790600070060408320401907
720004000900012050105790043401005000000000000000100402260058901030620004000300025
800500009070241080000807000096000213020070060438000790000103000080764020200005004
800503090400000215050740608000000004302050109600000000906075080145000006080109002
800600023300740050000010400001490730000107000078036200003060000090071006120005007
800603057750000080004800900400060509000408000601030004009006700060000043130504008
800617003030080070005300100200000904480020017103000006007009200040070030500863009
802000501000300400934000002009020007083609120400050600700000916001006000205000703
805940036160000590090006008001000007300080009400000200500800020019000074630024905
810740063000385070300006005002000000600574002000000500200400009050623000740018056
820650701006000209710090050000000007902000104300000000050040036203000400407068012
835007006007000108060308027503000800000090000002000704780502090309000400100900385
896002003020013087007000402340000000010000020000000091402000500650240010900800246
900005008003600500010809030301904680000020000092503407030408020004002800200700005
900200437100007000800063000068502003001000500300801790000720009000100005587009004
901080003087000520036000781000703000300000006000108000729000460045000310600050807
903000600010080953065900084000000068020000040650000000270005430346020090001000206
904020678250007010800000003030090000700304006000010040600000005020600094197030802
906100002050070040001092305007000004024030610100000200402860700070010020600004109
948200006000740005000006003009408052030000010570301800400800000200094000600003924
950000000100000090604200517006047350009000800045960100861004705070000003000000041
970180004046000037005000190000902005700060003600503000017000400280000760500024081
970200436400080007105000200000405002060070050800103000002000301300010008681002045
980350042400000709060040000000060004607504103100030000000020070304000001270083095
960058013240000578038700900300102600700000002002907001009006180176000034850420069
