198
000000000000100002085400306607800000001679500000003907504002790200004000000000000
000000000009008107004000020040100076500306008710002050020000900308200600000000000
000000000020800590045160200000000640003000800071000000006074310089005060000000000
000000000090802030005400100020305460000070000037609010006007500040201070000000000
000000000095000030000142050006705100007000200002903800080316000060000510000000000
000000000210003050030007002500806000870090023000304005300500060060900081000000000
000000000504020070000006090090210063003070500280035010060100000030060208000000000
000000001800900000000000630081203046500040008240807190037000000000001009400000000
000000030407035000000801020024000500070050010006000480030106000000790103060000000
000000040020009006734006009002070000006000500000080100400100653300700080010000000
000000080204030000000019060001403000053000620000207100030580000000040203060000000
000000200173902000000700000501080000640000012000090604000003000000108579004000000
000000408005087200000503090007000003004020100800000700040208000008370900602000000
000000500070009028000160030000071009800090003600280000020057000340900010008000000
000000730100834000200000000050403090080010020020907050000000005000641002032000000
000000900071300040600100020000406870000000000017503000090002003040009210002000000
000000900370085000080200000653000000004937600000000283000003010000150027007000000
000001003060053802810000006000300009000090000600005000100000098208970040400800000
000002040000308009147090000005000000890000026000000900000050163200604000060700000
000003010705002000080000400357000040600090005090000327009000070000400809060900000
000003060706000090009000701500400080000521000060009002205000100010000908080700000
000003800010005640000600000800401700002030900003206005000004000029500060005100000
000004000008100070090850001000009120010000040052600000500043010060007900000900000
000004000070000350019802600501000400000000000008000109006308270043000010000100000
000004510010050260000000900020000080300628009070000040002000000098070020061800000
000005020090600038000100000000090580002506400065070000000003000750009060010700000
000005900070020030406800100500000400020000080007000003003002805050030070008400000
000006000000028500060400000420105800030000060008702049000001070002870000000200000
000007208000309000000005070500070800102050406003090002020500000000906000804700000
000008020100500000005024300203000040009080500050000609002390400000002003080600000
000008070290000084000002000002405100600000003005907800000100000420000036080600000
000008700070000430319040600400000000005020100000000009008030926043000080002900000
000009003000000029031207000002160500000000000004028100000306870360000000700900000
000009205012870090500000000000100004008000300600004000000000003080021960107500000
000019000000050300061000800900802000540090032000405009005000410004080000000970000
000030200000005100519600700020000300900000008001000070006001532007200000008040000
000030600000009800518000400050010000900547006000060050002000963005200000001090000
000040000031700080000006050005010020700923005080060400050100000070008240000070000
000040006800020010907000002000500001050914020400007000100000903020030005300090000
000040081630058000050007000002000300100000002006000900000300050000960037340070000
000050070680001430020800000010000700200000008008000060000004090035900027090070000
000050800000309000701000500020090070900207003010040090002000604000504000004080000
000051000000600480020490006800000007009030600500000004300047060016005000000810000
000063000070000040006090300500608000902000608000409005008010900050000020000280000
000080020500001094000906010050003100000020000008100060090704000830600009070010000
000080250100300700420100000000000680500000003069000000000003018002005007098010000
000095600001006000800000010790403000600050003000608041020000004000800700007930000
000097000020000009060400000002970306008020700406035900000006010800000050000350000
000103000010042850083000040000000100000908000006000000030000460065430070000709000
000190800006500000200030050000000025603050904570000000080040003000007500005026000
000201030495000010000000080200080007000103000900060004060000000050000672030604000
000208000005040000000690080100000702038000540702000003080073000000010200000504000
000300000010040007020600009000200600051807930004005000800003060300080070000002000
000300902500000001009000800001902030080060010070805400003000100400000003705009000
000395000000200000007000800300020057500906001210050004006000100000002000000518000
000400010700300800068000000010920048000000000580061090000000680005004002070005000
000409000000000200090350000200901805005000700703605002000087050006000000000203000
000500000002006500070080010080907004001000700400103050010090060005600400000008000
000500100000027600480000000040305007030000040600102090000000089009230000006008000
000508000060000080007300200500204109000000000301709008004002600090000010000906000
000570000006000300093200570000000709100000008804000000038005490002000600000036000
000600400500000100000008070700400502301000608902003004080500000005000003003007000
000601000001070000005008930908000003070000090400000608017400200000030400000709000
000605100090020000208000643706000000000000000000000405315000208000070090002803000
000620003007000200005000041006300080003000600090004700140000800008000100700089000
000702430000000829500080006000600000800040003000009000700020004916000000023106000
000800010403000000007506820009000701000070000504000200052601300000000106060008000
000800400750000002603002500001090000300020004000060100005200308100000075004007000
001000000000800000002037905007020050003109800060080100509270600000001000000000400
001500700030000080800601004006000107000020000305000400900207003020000070003009600
002070030690000250070000008000706000300080002000304000700000090049000016060090400
002406500001000000400000063100070008000608000600090005380000007000000300005201800
003000590080040030000260800060000002008000900700000040002087000040010070079000400
003000829000701003049000005000002000900080004000900000500000210800506000392000400
003040006000007280002006090000000400290070018008000000060200700021600000500090600
003587000000040000009000403900000006120070054600000008805000700000020000000651800
004320700000704000600000001010000068500000009820000050300000004000609000007048500
004500300000090100870000009000803002030060050700409000900000034007010000003008500
005000000000630000000082009002401060098000210010803700300510000000069000000000400
005000000030041870020000009080509000050000010000306050100000080069430020000000700
005001020402000000009700481500000200000040000006000003184007600000000804060200300
005001300030090010400000007700102000060070030000506009200000006070060090001900200
005010000000006800030270005010000700902080304003000020600047010004500000000090400
005080000000001000306009702004300100090070020008005300401800507000700000000020800
006000800010000020900720005000601400003070500001508000700092003030000050008000600
006500000000080300090076008002000007057000260800000400600730090005020000000005100
006804000000901000000020001680000027004090500130000098200050000000109000000602900
007000004000006300090002600010027050000301000030540080006100020009800000300000100
007060030600400000000039005006000080705010402040000600900570000000001008060090300
007300090300100000000640001000000753002000400785000000200017000000008002040003600
008000400000070002054803600000008035000030000680400000006307520200060000007000900
008000620000002507070140000021090000000000000000020490000079010507600000083000900
008001900030704050400000003350000010000040000060000024200000006070405030003900700
008050000305000006020900000901402000050000010000305402000003040100000903000080500
008050060000006000009804020000047090000309000030610000070903100000400000020080300
008203000006005000000000045130709008000050000200801074810000000000600200000302700
009004601007000000000060002654900800000000000008007493300010000000000700106700300
009007400000040000108000502400509000010080020000206004201000703000090000006700900
009070000000642000000009003067000090280030017010000280500400000000583000000020700
009200040130060050000000007000030001080597020400020000200000000060070013050002700
010400000003090005000208060009000102020000080105000400090605000500020800000009040
010400050780000091000207000001000304000050000906000200000709000360000047070006080
020010900060000084400002000001070000700203008000050600000600007340000060006090040
030280070900400008000000000000020036600971002410060000000000000700009001080035060
032100000010008096000000001080050009000913000100040060200000000470600020000002540
039000000007030001000006908400000003090872040500000006201900000700020300000000280
040030600106002009007040000904000000005020900000000803000060200200500408009070010
040060100000100809350008000009000050700000006060000200000500073107003000003070060
040801000007002003000006090358000009000080000100000348070100000500900800000205070
048700500000800003600009008001000064000080000870000200200100006100003000005004120
049030000000020009003100608000000100510000042007000000601003500900070000000040970
050008024700030000004000000070000690800706005029000070000000700000050006180300040
056009000400800200300000000000100047540070039170004000000000001009001002000300580
060000000012907053000001000004000006030296070500000900000300000190705630000000010
060100030830004026000009000098000004000090000500000780000700000670400095040001070
060208000020100090000000170004035000070010030000670800092000000080003050000906080
062000008000900056000000030003109200000208000009703500040000000690002000500000940
068015000000020003000800004800000700140000092005000008900008000200040000000690210
070000010408000006009600240000070600000162000006030000057008100100000803040000050
070000080610000072004002500007804000000030000000207900005600300930000058040000020
070000090500008002002017800081000000006040200000000540009270300700400005060000070
070008030300000002000706000205107600000000000008602305000803000700000001010400090
070038020900000003000001000806405000100000008000206501000900000500000004030840090
070300000009605008000080030040000071002000600780000050030020000500403100000009020
070508000039000078000040090800000004001060800200000006010030000940000180000407050
070600005000204600008070000409000002006000100300000504000030700002407000100005020
078000000000000050000601047201300080009080100050004603160507000090000000000000710
080000000035000090400180600000700809002050700108009000003094005010000930000000080
080000400000590208620004000008000090050080060060000800000300019207019000006000020
080507000001000005000084720100000000070306040000000006052130000900000600000409030
087000000000002006000603009025104300000050000004907120500408000100700000000000480
089640000000930005000000008000000032520000084760000000100000000300062000000051970
090000007003905020000410000209000080040000050050000603000078000010602500600000090
090000080600500203070901000005000160000000000048000300000704050706003009010000030
090003020700000609010820000400000500002010400001000003000052040208000005040600030
090050200000000007306008100002060000900534001000080900003800402600000000004090050
100080029900000000000503000002806300300000004001302900000701000000000003530060008
100200060500000000000100900402507000801000509000804107005002000000000003040009006
107902005008000000000070036900000001001080600700000008270050000000000400300806702
109080706000009000300000005040020000500793004000010080400000007000500000708030102
200000105030000020800049000007090000009831700000020800000380001050000040108000006
200060091804300000000001070009000030100000004060000900090500000000004809470090005
200400006097000830040000050000060001000109000400020000080000040053000960100002005
200800107000020000750000069000000048400000006130000000360000072000040000807005004
200940105000007600180000000090000002600050003300000040000000079002600000509018006
209307100400002000005060007080000006000050000500000020600070900000400005008205701
215000008006000000700001043060300100000010000009006020920100007000000300800000591
230000690000090000005000010100500800097000520002003004070000100000040000018000057
291000003000670000070000200005003002009050800800100300008000030000037000700000659
300000082401009000005000710010706000000050000000901030047000800000800407890000001
300090006005600900020000050000040080400309001070060000040000090006004300900070002
305000108008096000020800000000000085000401000760000000000004030000730200807000504
305007062600200000000000001700010020000902000010040008800000000000006005260700409
310000042500008003006000100050104000000050000000907060008000500400800007130000084
360000050008000000900670000409003001600000008200800405000021003000000600050000074
400000003000208610072000005005300000060000080000005400600000190084702000900000004
400000096306009000000001040035102000000000000000403910020800000000200305560000009
400087000000001950050040000080005002000803000300100080000050030079300000000270009
400700001020001460070600000080000506000000000704000080000004050069800040100007002
401000009605700300000800000000009008039000470700400000000004000004005601200000504
450000003000710008030006000045090002000000000800040960000100030900084000500000041
500000073400000000007102500005209600000010000003504800001806900000000005850000007
500900800020000040001000700600290000082030690000076004004000200060000010003004008
502600409004000000700000028000040001000236000900050000860000002000000300301007604
600000000000070104000008900000402068042000730560307000003500000108090000000000002
600000001000108200020050000070406080002000500040503010000080050009304000100000004
600000005100034020008096000000000586000020000493000000000910400040250003800000002
600005081900000000003810700800000600009000300001000009002087900000000007380400006
600094017300000600080300000500000700900010005004000002000003050008000003450260008
600700008000054000003100700050000409060020010102000050006008100000390000200001006
608030090400500000010780004300000000000105000000000008200013080000002005090050701
620000000900708000000510072000002000430000051000100000240069000000804003000000065
630000008080001056000004000094080000000739000000040670000500000150400020800000014
670080003000005000100700400004009700006070800002100500007008002000500000800030064
674500000008007000000006590000100430000050000091008000087600000000800200000002385
690400000430000008017000000002601050000040000080703900000000160100000087000005042
700480003009010000003000590000000004860000075200000000091000200000020400400076009
800000060009000000020000738070300400010694080006007050657000040000000800030000001
800002000900006014400007020001005000300000008000300400030100006280700003000500002
800016003006009000007000680490000000200000009000000068029000700000700400600250001
800096002001070000002000910700000000920060074000000003065000800000010500100380006
800730090000100508000400000708000100090040020002000607000003000105004000030021006
805009007060007050000200009930000400000070000004000085200008000050900030600700208
806930050500000000000600700002090380000040000049010600007003000000000003020061907
813700000200900670000000040000000060430080052050000000080000000029008005000005281
815000009000604003000000005070903010000070000040502030300000000100708000900000372
840000306000040007200130000000000800018000630005000000000056003400070000706000095
900003040001006705000070000070020609000010000804030070000060000702400500060100007
900003070006000009507900000010098000040060020000230010000006703100000500090700004
900007003000006400050800000540020900000508000008040062000004010001600000700200008
900062000507000009006300200000009008080000070700800000001003900200000106000510002
900106000028500000010400030000900520000040000094003000030001090000007650000804001
900400301000000000301060200000902005009050800200304000007040106000000000105007009
900800000010000600000060070001049058060000020540380700020030000007000060000004003
901240060000000370040500000000000710000408000085000000000005090067000000050076102
905010040810003000200700000000002760000000000063800000000006004000200081040090206
905800007003000000000006052008020005000304000300080400410700000000000600500002704
906001047300600000000000005200809050000000000010204009600000000000007002450300901
