200
000000000004800200010057030006205090002000400080703600030670050007002900000000000
000000000020006480070309000013050200000821000004070160000105020085700010000000000
000000000020900780010530000000020860006794100051060000000086050089007040000000000
000000000024300050000849070007000840005000900038000100010567000090003720000000000
000000000047310060005700980000000840090000010056000000024008300030061270000000000
000000000083020450010600080000050900030208010005040000060001070078090360000000000
000000010304800000000069080008604030007000400030105600070420000000007305020000000
000000040900300600016097200008000010004060500090000400009140350002006009080000000
000000080204007500050106040067000900000000000003000810040203060001600705090000000
000000300000910000806002500001603050020000070090107400003500207000039000008000000
000000500008020000200784010007000300092000470001000600010397006000050800004000000
000000560890000030407003800002010000000207000000080100004600705080000092023000000
000000600002004500510700020040102700000060000008409030060005097004600300003000000
000000830680400020407010500000000080001000600070000000003060901040003065065000000
000001000004003600080005010812070000000108000000060981050900070009300400000400000
000001400040000670150300000200706800000000000001509007000004062094000080005800000
000003010500000400030290000300502900009080100008901005000019030004000008080700000
000003020104780000006000570300000060080090030010000004043000200000045703070900000
000005000063010820020009030502000000080000070000000403010200040058060710000500000
000005200009000100460082030705000000006050900000000307080920041002000600007300000
000005400010360090800020000400000080082040930090000005000090008020034050006800000
000005490890000070700806000601000300000000000005000802000204003010000027026700000
000006080600090000003250900100000700058070160006000002005089600000040005080300000
000006970700009800480500000120000700000030000006000084000005036005200007032600000
000007020700604000000030000420708090007010400060402017000020000000305004010900000
000007250700000800649020300900000000008030500000000008003060482005000009076400000
000007900010900080402010600700000010004000200020000003008030402050008070003200000
000008600000007000307190800610000200005000400003000068008019705000300000004600000
000008700000105000300060000750209030008070400010403079000050001000602000005700000
000008900058000040100046080201000000004030800000000203060410002090000460005600000
000009000073001240020000030280010000000804000000070059030000060041500720000700000
000010040952008060000090070060000000703080609000000020020040000040300185090060000
000020030507900000000705080003000210200000004081000300040103000000002405020090000
000026780200000000400870000900000200705000408008000009000091004000000005032740000
000030070108600000000005010002060040400307006060080700070100000000008402030050000
000030100006000000407600920000060400300791008001040000062008507000000600008050000
000037000000000100019080400700603000301020809000804007008050240004000000000240000
000040060190002830020005000036000000900010002000000470000100050075800014060050000
000053040600210000000900000400000710310000096058000002000007000000038005070420000
000070900000400000205809600004000130500010007063000800001905406000001000009060000
000080000070029630040001000034000000190000057000000920000800060057460090000090000
000085200000209000300000000760090080100703006020050041000000003000307000008520000
000090120300007000904050300080000000105000902000000040007020604000900005028060000
000090700000540100540000000000060030230801074080030000000000083006073000003020000
000094000002700000000005030306209050900040006040608207070100000000007600000460000
000100000038070050006004970009000001020000060400000700012900400060010280000006000
000100030490060850020000000000010004050386070900020000000000010036090087080003000
000190000007080900040200060000000603150070092206000000080004010009030800000012000
000200130140000090200040000000030006003461200700050000000080003080000017026003000
000240000060000930045000600000080002400902006800050000001000590054000060000071000
000290800000000400160300000000040902300689004905030000000006051009000000007053000
000500000003000000007610490000060801008702300605090000019043700000000500000005000
000503640100000000400706000306000801000000000807000302000309004000000005095207000
000507900020901040700000000250000064000000000960000012000000009080109050005708000
000580000040020760010003000003000006790000043800000900000800070057060010000079000
000600000004001000000730040030806105007000800809104070050013000000900200000008000
000600010371000050000002040009020003000509000600030900020800000060000598050001000
000640590400005300210000000070000006900070002800000050000000063001200008048067000
000658100000030000400900000900000807270000063103000004000005009000020000005817000
000700080700900000002040900000306097004070500960804000006020300000003001030005000
000700300000008000302060100050407002008020400200806070005090603000300000003002000
000700840600100000102000700000030094000904000590020000001000908000008007037009000
000704030100000600080900000900040206000392000701080004000009050008000009090405000
000800600000056000203000400080604007020000090500702080004000809000480000008001000
000900000001763000000000080060030028080627040450010070070000000000352900000006000
001000000000008400027010908010205000005000700000609010409030580008400000000000200
001000000004092600070500039090000700050080060008000050640001090003750400000000200
001000560400005000607000301030407000000020000000109050102000406000900003046000800
001080900000200000204000501000502010600090005080604000706000403000005000005060700
001090000050020080004300107000000700890040052003000000309006500020080030000030600
002000800000070000706094102008000000079060540000000600501820403000050000003000900
002006100000800400960400005700000890000000000028000001100007036003002000004300700
002017300008000000400300097300000200100000006009000008940008005000000900005720800
002700100000000000800156004001000508007000300405000600700349005000000000003007200
003001200000709600590000008910000030000080000070000056600000097005103000009600500
003002060900000000007001905102040000000906000000010403506200700000000009020400500
003004000000671000000080006530000090087040350090000048100020000000135000000900400
003020090970000060004006105005000000400050007000000900706400200020000048040030700
004000300001800000300007019007040080000603000020050400630900004000005100005000800
004003000000009000000680007820907300009020400006805012300058000000200000000300100
004080200000600000107000305000105040900000006010304000608000504000007000005040700
004200000006009000000050017060040008009316400500090060190080000000900700000004200
004200050700000000009060208000050009007821500400090000602030100000000005030004600
004507000030640020000000001900000045040000060510000007700000000060019050000208900
004800090600904100020000005070000038000000000980000050300000080001306009040009200
005000010340008070000001004012040000000527000000080690400700000070900048060000300
005003100040000030208001904702000000000000000000000306904700803060000020003500400
005900080800700000000030002000801063009000100730509000900080000000005009070002300
006000000030920570040070009000000090029000340060000000100040020097061050000000800
006000010500000300027060509000106000003070900000405000104050860002000003050000200
006075000080000240040000006100050000500719008000060007400000030071000080000590700
006100000007000000000790015000040802002905600103080000830069000000000200000008300
006820900000400000700000004000204079500060003620703000900000007000008000003096800
006980000008005000000060021010000006709000405600000090560010000000300600000026300
007010000000000900020069005009080000408102509000050600300470010004000000000090200
008000000050020040001400803000206700030050020002908000605001300090040050000000900
008200570500000000306700804000000207000040000409000000602008105000000003083001700
008900570300004000900000008060040001000876000400020060600000007000700002094005800
009000000001400700073008564007000080000030000050000900942100850008007300000000200
009620000000004000007009403058000009300080006100000240905300700000800000000015900
009830400000600300570000006000000071600000002710000000400000065007009000006025100
010036000004005008009000750230000000400060005000000072048000200700800300000120080
010079000000030008000200000600304200830020015009105003000001000700050000000960030
020600090300200501010000000000070028000562000670090000000000040901008006030007050
020800000018060037000090020000000002081070460900000000090040000270030850000009040
020900600000500003400300000000403597000000000159806000000008002300005000006002070
024600010600700009000030002000000097001070200260000000800040000300001004040008620
030000000004905106070006080029000030000080000050000860090300040605408300000000020
030000000008306002000870010050000460001020700043000090090035000700902500000000040
030005040500000708090063000905000000003080900000000102000630050807000003050400010
030940000000001205040008000078000009400000008600000450000400020503200000000067030
040000000070061023000098000086000000024070890000000540000510000630840010000000030
040002000000401008007060900970000030008040500050000062009020400800309000000600080
040003000050260097000001000509000010060070040030000208000100000320094080000300070
040010630150000092800700000000000900900080004007000000000004009320000086078030050
040072000000000005000906000605030800300789001001040902000103000100000000000890040
050030400000020006209000800000509000570000093000301000008000107100040000004010030
050200760800300001900000000000040015000123000130060000000000003700001004061007090
051007000006000009000850014600000900009080300005000007530018000800000200000200890
052907000080300096000000008100000047000010000290000001700000000530004060000109320
054000700000300001600004005007050040000269000010040800100500008200001000008000170
058206000000005206020000008310000004000040000400000083800000050903400000000901630
060030000080079043000050000040000000573000294000000010000010000190640020000080050
061000070700080006000900005000508400070000030008209000400006000500020008010000640
064900000000030005001020809000000008036080510500000000205010400100060000000003780
067410000000020005000700006000000104940060052205000000500006000800050000000097520
070000000000080503010320000000403700054090130006502000000039070908050000000000080
070000900000019006506000100030020000020805070000060050009000304100270000002000010
070005090400006007000802000286000400000000000009000178000401000300600005040300020
072009030100500904030000006500000040000020000040000008200000060301004005080300410
080000640600048003700100000040000500020070030003000080000005006100830002065000010
080000920600020005400908000006000700010070050005000400000109002900060003021000060
080001070106000004002005390304000000000070000000000209063500900500000108070800030
080360200000001005600020000020000001708000502300000060000010004200600000009085010
080600900059000017100003060007000006000000000300000100020800009810000570004007020
090040070600300008000100000000030510900508002072090000000003000800006003020070060
090080000080023075000400000030000400420070089001000050000001000160240030000060010
090804020750030069000000000600000007080000090100000003000000000230090081040701050
095000070800300001006000203000205060000000000020103000108000500900006008050000340
095040000002090008000006047007000000130080069000000200920400000500030600000020350
100006702000104000206000300930000050000090000080000079007000904000403000401500007
100030007000820000003100200000000140870060052015000000009002300000043000700010008
100070439700090000600400000000000200530000064006000000000006008000050001247010003
108000007007209000000500042040000270000090000076000050790004000000706100200000704
108200006000005900020400003050000801000000000902000070400007090009100000800009102
140000002060800075000400000000307950000000000071209000000005000980001060500000094
165000007000060003002000109000201000080000070000809000506000700300090000800000925
200008001030500090000020000100070080007806400060040003000060000020007060300200007
208000009000580000000040007000803040013000850090106000300090000000017000500000103
210080007080009014000100000020000900100020005005000060000007000650200090800030021
230000075700006009000209000062000700000000000004000310000302000100900002320000051
250000063610800079000000000000605020000080000080102000000000000540003096920000085
250003609000000103970000000700060000000749000000080005000000067609000000307400092
300001006060009410098000500520000000000000000000000087003000170084700050700500003
300070405000006700610000000060030000700412008000090020000000054002300000408060002
300400081700000500020800000000080106000632000807050000000003070004000009630008004
304800002090000460020030005000000004007000800100000000600020090043000020900005708
308007406000000500790800003200000300000000000001000008500003079006000000903100205
340000005006800007001000490000050020000928000020070000017000900800006700900000018
340006702000000001806000500400803000000020000000409005008000206600000000205700089
380000076400809005000000000090080030000921000010070060000000000800106009240000018
380910602000000009100000000000807003400020007200405000000000006600000000705036041
400000892200300000500008000009803060000000000040207500000100006000009004168000005
400069052908000000000500090800000400100000008006000009010007000000000703260890004
400090008010000070003070600000204000208030407000107000005040700070000080800050006
400600082800090000000002000005201009010030040300705100000500000000010008650007004
400830001060700020000002000003000019100000006740000800000200000020006070300015004
401000003060080290070200006000000900030070080007000000300004050049050030100000609
403000006000040000008010309000407000019050780000109000206070100000090000700000503
405000608090070010800000002000204000030000060000903000700000001010030050509000704
460000001008000506020500080000709400000040000002301000090007060201000800500000094
468000007000001209020000004070080000000305000000040060200000050509800000700000846
500000601000003000409002300021070000000609000000030420005300706000100000804000009
500370806001000000200000030000010005700902004800030000090000003000000400307059001
503000407000005900820010003040000000005080200000000050300060085008300000709000301
503090002008006000000000075040070000100905007000040010280000000000500300700010408
520040003000700001000300000000070980800403002075060000000006000300007000200080095
540000007000040609030702000002000700010030060006000300000501080904080000700000053
540060208000000003900008000003070000800542006000010900000600009400000000609050021
570160902000000003800040000000000007904010506600000000000080001400000000209054038
600000051800007000000240000040060200001594600009030040000076000000900007750000002
600000508007100000900020040000030020003806400010070000090050007000008600105000003
600000785780040030500002000009000000030000070000000600000700008040030057176000002
638001045700090001000000003400000000050000060000000007300000000200070009940500128
690000007040200019000500000000090740000173000051040000000004000570008020300000054
700002004058041070000000080920000000080000030000000012030000000090580620600700009
700010008000000000008903600009605100800000004005204300006507900000000000900030007
740090001006370002000000080000000090480000015030000000070000000300068700500030046
780500401000900203120000000000000069000040000890000000000000045302007000901004026
800000009004109000009000730060502070000010000050408090018000400000701800500000002
800300009000002000007050600060070002003819700400030050005080900000900000600001005
800307059500001000000060000680000003004010800900000064000040000000600001710903008
800406205000008000902000300140000008000000000600000031007000109000200000401905007
806004905000005000900030007530000000004000800000000043700090001000100000603700409
890500006004009001000002070037000008000000000500000410050300000600700300400008059
900080003000002800060405000086000300500010007009000160000504030008100000300090005
900470002000000000007035800009000004203080106400000500004790300000000000100048009
900720068100000000000104000008000509700000001405000700000506000000000006250018003
906000003000540000000308005008000230020000040091000600400106000000037000300000107
980000003000307508040000000030105040000030000020908070000000020804709000200000087
