200
000000000020010640097008100006903000040070080000506200003800490071060050000000000
000000000061500000080002090704010806200050003306070901070900080000005430000000000
000000000094030010000209050008903200030070090007105800060804000070060980000000000
000000000100005090704200800300504600080000070005103004007006502020700003000000000
000000002204100780001065090000074000000000000000820000020510800065002304300000000
000000008800050047009410000040000000063201450000000010000079800130060002600000000
000000020043000000000206401007490203000080000805027600704501000000000910010000000
000000040500090000000731000009040300031802670008010500000579000000080001060000000
000000080250400030001030700000020010003501800060090000007050300020004061080000000
000000090100405200050100000060503180000000000018706020000001070009607008020000000
000000200060073050201050700030000000079000420000000030008030105010860040002000000
000000200400100000000306005000092360503060708062830000800605000000004007006000000
000000520302900000805000410000405070000080000010302000098000601000006702027000000
000000580130056070700000000080010000050423010000070020000000002040580091071000000
000000806040060700000000500001005047070608020430700600005000000004020060903000000
000000908706090003000000000051400020270060014040005360000000000900030601105000000
000001050600907000000630000590000380007090100084000026000026000000704001040300000
000001700090030020807020500500000000039050470000000008006070805070060030004100000
000002000063001070001050890940000000008000500000000038095020600010600420000700000
000005037040201650000600009000900000007010200000008000700002000051809040890300000
000006000007200500020030090800050020002419700030020005070080040006001800000500000
000006000053490010000005020209000040030040080040000609020500000070019850000600000
000006500009003000070801020600005200030080070001200004040308010000500300008600000
000007020800000500030601000207040900000582000008010602000204070004000001070100000
000008390000000056007502108400000000005000900000000005209704600540000000081300000
000010000030000506800400000003050027090836010160070900000007003708000090000080000
000014000000700000008200900700020510400871003036050007005006400000007000000590000
000017600000002000706000400580104000100070008000803012003000206000300000008920000
000030000000400600030062000005020030304706805010090200000340010008001000000070000
000030120300570000800001000004000060270080053090000800000600008000054009038010000
000032800062900400090400700100800000000060000000007004003001040004008970008240000
000040000080500060004010500000809020502030607030702000001020300020005070000070000
000041000000800900087060500100000030908070205020000001004010850005009000000320000
000042070870001030000000000250070000900206001000050096000000000060800049040930000
000042900000001400800905700070500600000000000002007010003109002009200000004630000
000050000000986000002004700054000070970000063060000150007200300000438000000060000
000058600000000000700610000200306400306000807004807009000035002000000000008260000
000061400040000680280300000400000900800000005003000007000007016037000020008510000
000070900002000035300001600094300008000000000700006240008200009420000100005030000
000071000080000010006002700208407000400050001000206508005700600030000050000590000
000073000090000030006040200700604000605030804000805007004080700080000020000520000
000080000040609010000240000090000160605090803073000020000035000060904070000020000
000080020020005009000703510090300700000050000002006040078602000600400070030010000
000081309600003001050000007007000504000010000409000800300000040900200005805430000
000090000000704200030610000020000310604000508091000060000047050005208000000030000
000092000003080002008610000900005310000000000036100005000073400200050100000260000
000098000000006000006250800950000300608000209003000015005032700000700000000510000
000100000062004800070008000009007040020649030010800700000700050005300610000001000
000102800000009000908000300310070002000204000800030076007000609000400000006501000
000170040720004680010000000070000005600000009500000060000000070035700012080029000
000200050400300000006470200000000384008030100123000000007023900000001003050008000
000207000004500900030000060600308051000050000980104007020000010007002500000405000
000207000500046000010900080000070030008425100090060000030004010000510007000608000
000270000000010000004008900005701004780030016600509300003600100000090000000027000
000273000050000360030000000900806002600000003700509006000000090014000080000412000
000275000005000100090000050100708005300000001200309007060000040002000800000437000
000293000006700000000004090605000038700050006490000105020500000000006500000128000
000300000000954000002007800097000021030000090120000540006100200000429000000005000
000300000090680530040020000000000029058090340120000000000030080085017090000002000
000300071030004000000060090000610480600020007041053000070090000000500020950006000
000390000006000000000702050007501902600000008205804100040105000000000300000047000
000400030600000800040902000005040107000107000104030600000308020003000009090001000
000407020100009000000013000524000006007040800600000149000790000000100005060204000
000419507984003000000000000008000900030090040001000600000000000000100752105674000
000490700002100508300000000705000000290000043000000605000000007506002400009078000
000500600027900030800300040000000265000080000935000000090004006040001790006003000
000600070000090080003008009607023000400010007000480902700100500030050000080004000
000690000100400000020100800000710500501000207009046000006001090000007001000084000
000700000000050100080034000009206007072010430800309600000980070005020000000001000
000750000046000020000092030002000001801060702500000300090870000050000870000024000
000750800009000000103020750000000002204000109500000000047030608000000300001082000
000800290400063000200900000070000901030000040508000070000001005000690007041005000
000801000030000060005200800600070209000306000504090008006007500090000070000903000
000804010260500090000000000900010073000607000830090002000000000010002035050901000
000908001019200000500040700180000060000000000030000049001050008000002630400309000
000910007030560002000000001002100090300040006040006700100000000200081040900073000
000950400006070000205000790000000003670030059300000000047000801000020900003097000
001040000580000190000010007100200050300070006020005001900060000018000074000020300
001060000050008300900042000010500602000000000708004030000150007007400020000030800
001300000060408000000070500008000470023040190014000200007090000000803050000006800
001603002006900000500000000005000960600417005038000700000000006000004300900108500
002000706400081000000009208140000005000050000300000089203400000000360004804000900
002903000000050000000600004100090508030578060605010009800009000000020000000701200
003090060900000500060700001000060700800251006002070000300007090008000005070020100
003218000000000000000003005601040007300951004900030108400700000000000000000396200
003400000060020090000900005000304807080000060702801000400002000090010040000003700
003900000000003000008004605049030008000857000700090210201600700000500000000002100
004000000086075020010890003050000600000020000009000040700019030020460790000000100
004000100080003090100800007030402700000000000009605040300008009050100020001000300
004007320800010000100002006903000000010080090000000207400900002000030008078200400
004200750106000800000300000000013900002040100001720000000007000005000604067002500
004290010200040000000005009007000008360000047100000900900500000000030005050012800
005007020070000000900430000000084070630000019010360000000013006000000080020800100
006000050400000000007309806002030700000925000001070600308706200000000001060000300
006000070201800300040002061003000020000040000080000100920600030004005602050000800
007060500003000000065084009000100000029000840000009000400950380000000200008020700
007900380600000000100070009000601004006000800400502000200040007000000002094003100
008001450300070000200050006900000000074060920000000003400090008000010009092600700
008600000070009060002000109050060007000925000400080050703000600040700030000001900
009050200600047000040860000000400000120000035000006000000034070000570003004090600
009500000000219000000400008060000514010000030483000070100005000000187000000006200
010000090700409006000057000037000050008060200050000630000640000300102009020000040
010003780040000350006000000030004000507060108000200030000000500094000010075100020
010200070800100006000070000000607095004050200960304000000090000400005007090003080
020000000080004019000012000076040000003605700000070950000460000230800090000000070
020080000000001806040090000030708000408000305000503040000060010906100000000030060
020400600000076004800000000030104007040000020100905040000000008500630000007001090
020500000000098001001006700093000002080000010500000930007400500900280000000003070
029000730400000009500100008000709100000000000004306000200003005300000004058000920
029100300060080000300900000100000547000040000648000002000008006000050030006007180
030000700060970035500010000000000020075020680080000000000040001610083090002000060
030008040100004009005010300670000000002000600000000052001030500400200001080900020
030200000000008002002070600080030004001706900400050020009060400100500000000007030
040500301962700000050000000090000008800040003200000040000000090000005136306009020
045080000000000308070409005007000900400060001008000500200603010701000000000020650
047000005003000000900003610000010800002468900004030000076200003000000200400000590
048900000000000001000560007000010702003805100601040000700086000200000000000004260
050000020010020985000003000630100000000608000000005061000300000926070050070000090
050600040007008000600030070000060009304000807900040000080050001000400700060001030
059000400000400007300020005000805010005000900070309000700060003100008000008000160
060005048200000007000007100400803000090070050000104006007900000300000002940700030
060182000200000090000000004000074123000000000923860000800000000050000001000427030
070000000098003761030400050020000800000090000006000010060007090943800670000000040
070000400000809005900070000080020060003417800040090010000040008800701000002000090
070020100000006003501700900050000400400080001008000060004008302100200000003060010
070315040400700000803006001000000060000020000080000000500100206000002004060537090
071000600000004705540006008027000000000090000000000830800400069204600000006000310
074610000000000001003000407000105006500080003800406000109000300400000000000051890
080040200010507000500020010020006700000000000009700060060010003000903050003080070
080060700009843000000000030068500000020090060000002970070000000000725300001030020
092000004000000070580970003004090300000000000007060900400056032020000000100000540
095001000000030002000780006400000900017000620006000008700056000200090000000300150
095700260800050004100000003000000008040020090600000000300000006900030007071006530
097000000000004810008000060000200300850603041004009000080000900026800000000000620
100000008002170000000900060000040820040609050023010000070004000000036700600000005
100000027600007000005009300094806000000000000000204730008600900000100004420000001
100800009000120000000075000002000045056090270430000600000260000000051000500007003
104300000089040700600001000900000000350000019000000006000900005005080620000002904
150079008003004005000000090630000000500000001000000073080000000900500200200840069
190000326700006001300090000010000000009070800000000050000050004900100003287000065
200000006030007850040005000092040000000502000000030570000400020076100090300000008
200000008090500460058000900000070050000908000070050000003000670027005010400000003
200000401004030000600500030000050700010943060008020000040005009000090800302000006
200003001000000400070041000508302000001000900000806504000650090006000000800200005
200049170000010800000003065000000040003000200090000000380100000007060000065470009
200070094000005010000806003160000200000000000009000048900601000030900000670050009
200080700900001003000000160018000600000405000005000490079000000800900006003060005
200104007000003000008006200786000009000000000900000715004200300000900000100408006
200500006030007120040800000080000304000080000301000070000008040062400050800002001
209057001080000030000400006600000200400010008001000007800005000020000060100240903
260008005908150600000400000000000100700040009002000000000002000009073506500600027
270300004000900006000408000005000689000090000941000500000109000700005000400006012
300000004000940802400000590009006000100000005000800700023000008907053000500000007
300008002060200070000040000800010030007523600020070001000080000040005090100600003
300490002000500000008007600002000065700060003680000700009800100000002000400015009
300600075700000000001500800000208103000000000103907000007003200000000009250009001
300800042500070000007000800000010006060504090700060000002000300000050004930002008
300850009000376000000000000030000026160090074580000010000000000000132000400067005
302000004000001700040050001070208000005090300000506010500070090003800000400000603
305080702000000000700600003000070100600102007003050000500009001000000000208030504
320000000000400100000080000103704680600000004047105302000090000004006000000000029
370106000000000000006023400060005080800000002030200010007430100000000000000802035
400200006007000000000960010000709204002080900704502000030096000000000300100003008
460857000000020700100000000327000040000060000080000253000000006005070000000593017
500000002070005610090600000040106800000000000003408060000003020062800070300000005
500000024300041800070060000010000000068000340000000070000010030007530002230000008
500009070000300089010075000100000000070402090000000007000560030720004000060700008
500040900000000010029008600050070000037090520000010040006700230040000000002060004
500060009000308600000000080002085000081030490000490700070000000004103000900020001
500084209000007000100030000390000000402000105000000063000010008000600000201950007
500090100069000085000050007040006000000541000000200070400010000310000950007030004
500700080030800209040000060020040000000687000000090050090000010103005090070009006
504006001030000950090000002100050000000208000000040009600000020047000030300400506
530000009000070002001800007000461000050000060000539000200007300600040000800000025
580030700079000001000010000000300900006941300007008000000050000600000520004080073
600000003010000000003400090061040020704010305050020180080007600000000070500000009
600003807000400520020006001000000304000040000904000000700300010095001000308500002
600020084000960030000400002058200000000080000000007460100009000060032000930070001
600200470500093100000060000000800504000030000906005000000080000001320006039004008
600302007004006000000100080750000906000010000309000025060008000000900300100407008
600409001000010000000007000705103006080050030900706504000200000000030000200608009
600850000000000006051009020000060010002791500090030000080500460400000000000074008
608000000000100000250600078010000040900347001040000060430008029000005000000000406
690000030205000708000050200002800060000070000050004900006010000904000605010000023
700004806092005030600000010310000000000030000000000065030000002060800170901200003
700006002043080010000090040200000000081000430000000008050020000060040190100900006
700050086500310000000009000003000050940020067060000900000100000000072004170090005
700510004000002000002000100020106005400090002100703080008000300000400000200057001
700600081100020400090003000001000003050080060300000900000700040009050008630004007
708020003000004000009003405025000000900000007000000260103600900000700000600080501
780000002050000013001300900000020500000804000002090000007006200630000080900000031
790030001000000408010007000003406000900000007000908500000200060109000000200060059
800000000090204006300010000017060900020040050003050870000020005200906040000000003
800100006036000080000020040000040009004806200200070000070050000060000910300009005
800260509004000000100000020000010006200709008300050000030000007000000800607034002
802500000000030001400009000050083000097060380000790040000300008100020000000006209
803010007000027000000009000140000020620000053090000016000700000000640000900080604
900000000050000000108600230070004002003807500500900080062005709000000050000000004
900024000200007300008100500000900020005000700040008000004005100003800006000640005
904003050000007128008000000046000000002040600000000910000000500385100000020500803
