200
000006010004012007519070026140069750750000089092150034930080245400720900020900000
000081270408630000600209080901304720760000049043905108050802007000043802072510000
000104907008079061019620308083900000075000190000003480801092670920460800504807000
000108470060090000075460083916520800083000610007016359740031560000070030031605000
000143002010000470438700950342050000569000384000030529094005637025000090700691000
000208900070403510189006200961040052000925000750060394007500689093604020005109000
000210500800065140060800092395020400480309015006080239250008060074690003008051000
000504700054700090809206340903050476000403000641020803038102907090005230002309000
000603980760920304091048005029800570000000000085009230800590140907062053054301000
000614390509002010040900280210503608900040003304206071021007030080300104093168000
000698000048000060003142570401050807706209403309080206014927600030000140000431000
000700380500890600348210700000080217084107590731050000003071928009038006017009000
000871004287003000043560080002010803074908610308050700060025430000300176400687000
001346900000208000407100802360090257100827004274030089502004703000502000009713500
001760000000590600076203509004010932160902058239050100408305260005089000000026800
001900070520087001700201980600004098970805014280100005057608009300490057090003800
002009700017046050400720039570080900034107280009050071160074008040930520003500400
002034560045900008070265000256300001409000806700006239000721080900003410013450600
002100070835020410070630028000090703086503140307010000250047030093060254060002900
002600350706230800350009072001304068070000030460801900620400087004062103037008200
003025970240300680006489100100042060008000400060870001005794800091008046084260700
003046050420705310090100004270603490900000006084509032700004020042801079060970500
003084020002653009459001800008000654730000082546000100007400215100275300020310700
003508010100700000005162309906010725007906100312070904608351200000007001070209800
004109000059708060002050917970080045008945700640010092821070600030802470000501200
005041030416003090009050481360705000107020903000306047641070300020500614090160800
005041200080507340764200509210000450500000001048000092301006825056802030007350100
005068070798400530031050842100000080803000907070000003316040790089007421020190300
005300980200459700397100502040000618020060090683000020106003854004671009032008100
005974000070000150092510607300080501708201904601090003904058210086000070000326400
006010020305902600080304091079503410600000009031609250120406080004208105060090300
006090851500048302028153060900507000000304000000809004080936540407280006635070900
006310540100904000400075006075603021203090804910208670500480007000107005047039100
006510207705020016201700008600280450000605000054037002500009304360050809908062100
007000040690420070005783209003906520069000430052104900504297600080041052070000300
007063850830705010504000709390070020600329001040050063405000602010502047073490100
007201000410050627000094003201070034970106085530040701600420000743010052000507300
007300000031490260059600374000204618040000020128705000793001450082046730000003800
008032061006090200720106053002600310060371020031008700240903078003060500680250100
008051090540600270013004508901060030200405009050090702104800950095006027070530100
009006520385004760270500048120307900000020000003405071940001056068900317031600400
009100824783002050000586090104603700006000400007804503040968000070200635621005900
009572000075000210062003574206040007400605002500020406628100790054000820000287600
009601740420500008060207039700009801103000205602700003570902080200006054016804300
009780065702640309005910000004000691030501020126000500000038900608079203290056400
010089076600000290200476300000620947009708500756043000002834009084000001360190020
018056900020480015300070006100508060862000457050702003500020001680015070001630590
019006470703901002805007931978000040000000000020000685136700204400205306092300810
029045700037000012401700596300806100700000003006304005275003901910000650004950320
030580002070002010008716500810400329090801050356007084003258700060100040100074030
030602070600710900708049260000061437000504000346980000087420306003076004060103050
034600000085010267020509043008050401050701090301040500270805010846090320000003780
039150000060000719081049605003090007905601302100030900408510270357000090000087540
040091030508200907029700810100306420200080001094107005075002190901008204060910050
041732050260000079005060102400605001106000804800401006609040200320000015080213960
046250000010640253020007006004502097570000014690704500400800060761095030000076140
050001090809007004001924530798103600005000900002805471013256800400700309080400060
050012000006347208027000430610703020970000063040108075031000740504971300000230010
050070900009604703274900180020308560400060007068705020097006418106507200002010070
050092010391400600207610300032850006900000005700063980003026108004008729020170060
050312480090706502010050000900230040021605930060098001000040020208107090079823060
052600008098070100703028004027910403600000005905046710500760201009050680200001540
053602180240001953780900004190000402000020000608000095800005046512400038064207510
053701900018900523640030078400000087007040600120000004930070052864005730002308460
054061800008007506270800014610040200500618003003070069720004035405200700001750940
054086000029073015000002043146507000830020091000801467970200000260740930000310720
057800900046009821180034076035000002008000100700000390570640019894700650002003480
058902001070064825203085600090000103000701000105000080009520708526830010800409560
060001000130560907780300510006170800807405603005036400073008064408013095000900030
060003010800241509010650000320809450051000980098105073000086030602537008080900040
060005800000806204184920500590080340007153900012090085008071459409508000001200030
060210834350064002410380600000000069601000203890000000007053026500690017136072050
063704100097000624410500037600080703000439000301050002970005048135000270004903510
064009200001048007300056014215607000096000570000905826620870003100590700008300490
067100000050682003180570609004015006005809400300460100506031078800746090000008360
067508030325000986040020051600040008001203400400060003790030010213000849080904370
068307005040020003005000987056401208304000506801206370612000700400070030500902840
070030290203654001100702030012000740360040029048000350030906002700485903059010080
070059640900100007204806300708401950100000006029705104002908703400003005013520060
076020400500067200302100057900210064701000305460079002140002906007690003009050820
076200500000437209420800001080106452040000010615702090200008043108324000004001820
080005190000008006240000578400603751830901064617204003374000025500300000061500030
080057640204001705750400020930060400500749008008020067090002074105800206042970030
082009010605030008004208657807020900020805030003090801378904100400080503050300480
084025063160800200903000080070038610006209800098170050050000901009002048840390520
085000020302408906049001538016305080000000000050907360463800150501706803090000640
085002700600534100020006593079340600040000030006097840463800070002673005008400310
086023007049601023002700681501009030000060000020400108218007300690308270400250810
086300490500002603920740001070604308008000200401208060300065029102800004059007130
090280500207305908480601230000470805000030000709016000034108069106904302008063050
091705000070000629048032107402050006009683200800090703106320570924000080000408960
095000640070009513000265900108690704040000080306078201001586000564700030087000160
100006027709000145058417600001020003070834010300070500007169350815000206690200001
100200850020310000050789103046007308079000560501400270905672030000031080017004002
100250003500780490096104050354000100700405002002000548070301680031068005600027004
100300907008042000209607850081509402020000090904208710012403605000720100703001009
100700030948003200706250901000010058450807069810040000304076502001400397090001004
100940308002001904000837005804006053015000790730100806900458000501200400208019007
102709005060040270078320609800000702051070840706000001203057190015090020900203504
104008200007002480200594160090105870010000020032407090079641002045200900001800706
109700306503090000000385941000006428430000079268400000691248000000050102302007804
120009587750012094900800000580040100040593070007080052000001008830620015612700043
120650800075080063380100054000201006052070380600508000540009038230060910009015072
120704059600059120900001730000090600430206081006010000074600005061940002590107068
139000006000906102072015403056208010003040600040301580708190230301602000500000961
140563007306008009008900360013804070007000900080306420094007800500600704800435092
150904003024100085009050160500209071007000600410608009095010400740003590600405017
160000008050803067008764500086301720001020600042906180003452800620107050800000012
160020700380170000570800213000008970408907501093500000217003059000019062006050087
170005320560000908030708060402001709780000012906300805020107090301000057047500083
196000073300090806080362004002030900049601530001020400900486020407050009260000345
200046930500010002961300040802907000795000123000105809020001768600090005058670004
200050670405826000000400258630240001027000480500083062953002000000564907064030005
200086470009200530360075008080109700507000103003702090100490052025003900046520007
200481903083070140410900060100000206650090037708000009070006095029010680306859001
200708030000052069009400072040920085923000746150074090630007900890140000070209008
201000034980206170060470002090602510006010200012903060800024050025307081140000307
201800004056900080003016279004060095007408300630020800175680900060003450300009607
201900068850612070000080001010308029098000310630109050400020000020836047180005602
209016003070208410010430006460000530902000708031000042300064090096507080700190605
250306007006010902017008460409070001020801040100040206043100720501030600800607034
270038400000470068485010070018009025500000003630800910020090537350021000007580042
270980036090476100164300009000100005700209008500008000400002863009613040650047021
290000308000073906683409700031604200060090010004501860006208197109350000802000034
300102945400600700517004600106020078000408000820060504004900823009003007231807009
300608594200900000604075200709050026005786900830090105007560302000003007513207009
301700809000539200950801007042000735070000090695000410700305024004182000209007503
329050001047600089000290034000301970104020308063705000750062000630009840400030627
360002405000800307147590800800305640009000200023906001002018974704009000906400028
367590000481000095000080400814900530070405080093007246002050000750000921000028754
370806002004010805010345070601000208059020340703000501080973020107050600400108053
381720004002306007007004823015000076700060008840000350978600400100407600500018739
400000230710680509850009700038060470600803005075090680007300021301028067086000004
400050690501200408030074201045000823000432000213000940804610070107009502059020004
400081572720000190351072400205000000904000305000000209009620831032000054817430006
400090070079604018006780459030470080000805000040012030793058600860107590050060007
400560270860120000000300016040980107501602408708015060180004000000096021079051004
400659207012007004057014008001000472040000060763000800800190740100500980305748006
402038010185020003070019240001000062028000350650000100067340080800050427040870601
406980050503000800019200036904832000051000480000415209690001320002000901040029608
407060081800901000006740905070050860208603507069020010903085600000204009710090208
408002000210000047053046290000280039824000571930017000079530820580000063000700905
408260005001480000009700842000090724840506031912040000194003200000074300600012409
409002156762105080100090032370000090008000300020000078810060005050809213294300807
409508703560091084008600000900406800280000019001209005000005400140830096806904102
410079800206408900790605040304500001800090003100002608040801079001704206007920014
430006028200409306090352000972000480008040200054000167000813070603705001780200093
500007804078051620910080050680702000035090460000503098020030041096810570104200006
504000017960701450078003902085010020000602000090050340609100230017305094420000105
504607008000540700096300504900806241020000070645102009809003450003098000400205803
506700008081052730074008215017000004030000070400000820642800390058920460700006502
509102307007650000801000256600509048050000030490807002216000803000026900905701604
517003020060000059209601003005010207186000934902060500800105602620000090050200318
560004073100057604034020100340060000059201430000040015003080560905430001280100047
560300940010050007900214500800000673630108054257000008006842005700030060085006012
580300491709000008403508260008060705000851000106020900071902506300000109695007023
600004097500602000003578100824010730006823400019040628007251800000409003240300001
600034085402090700080120030900208400814000523006403008070042050005080301360570002
600100503300079241090030070036200910007315600021006350060050080219840005705001002
600342005042010960070600080400020108250109047108060002010008070035070420700431009
602008015704201000000076032316050040007309800090040326240780000000605204860900503
604100025301490000007030491000901073078000910130607000986050100000062509240009607
639040007000160309045970802000000980983000625026000000208097130701086000300020798
680100253000060094540039000005701409098040570407903600000590046950020000736008025
684750003000403705050906002021000537700000009493000680100809050906501000500027916
689052001000680005007001602402508010710000046030106807801400900300017000200960178
695002007080657900730004526900780002000040000200019004324900065009523070800400293
700000123820531070100027000075309010039000760080602530000210007040968051512000006
700100024450078060008240700080306207067020310304701050006052900030610082240009006
700100304010980060803706900004207895090030010178504600006801509050062040301009006
700840063100023000009076200031204007462000395900605410003760100000450009850019006
703004068260001040009803507496010200000609000005080796901708600030900012680100309
718690002062140079009000136000000015890010063250000000173000600480031590900064381
728004506009080002600792018907000100061000250002000703410639007800020600206800931
780302490400709001390000080073500802210070053508003170030000049800106005025907018
790030502005600001608204730003708910100000005087506200041902307300005100502080094
790800301040000957150679000009207408001000700407308500000451073314000090605003042
800050690472096001006030800000007368280903057763100000007010400900320716018070005
801002639900063000304590708670000300092000870003000056709058402000340007416900503
802060075761300920050702046007000590600000004028000700970506010036007459180040607
804200070002100045195030062700524090500000008040381007430010729980002500050003106
812300069600700008703810000936200800008503600005008392000057403300001006560002987
820000003000985402049013800081302060064000530030608920002470380403829000100000047
820030106001090350009600008073009064096302810480100530600003700015060900907010045
830400759407000000095870006081506000902307605000208970200085160000000504569004027
831200609700013000052000301370008026020146030160300084206000810000970002407002593
840057003006301005000860070320070610601203407079080032080015000900608700100730048
849700002026080041001400895000070504060948070704050000213004900690030420400007316
900008706506201009047605300209010070051030860060080902005109640600803107108700005
900018052512360070000002030301080090270109064050070208020900000090025783730840006
900502670050008029400709010179053000604000307000270196040307005590400030061805002
900801004078020500150409230045600003260040057800005640084907026007030980300508001
904030070173290000600780390840000057030802060260000031097018003000029745020070908
904150067308920100050000032000308096140000083890506000530000070007035209410079308
905200306001006400470390082030010907004769500709080040190037054007900600603008709
906004123400600800310289005809000230001020500045000706500136078008002004193700602
908070203030060980200930060002000876506702304371000500020049008019020040603050702
940700168600400903371008400005080012000542000820010300006800247204006009597004081
950000000000952076260040905630507800710304059008609037805060094190278000000000028
960058013240000578038700900300102600700000002002907001009006180176000034850420069
